10.go
..o.......
o..o......
o.....o.o.
..........
..........
.........o
o.o....o..
.....o....
.......o.o
..........
